╔═══════════════════════════════════════════════════╗
║                                                   ║
║                                                   ║
║                                                   ║
║                                                   ║
║                                                   ║
║                     ╔═══                          ║
║                     ║                             ║
║                     ║                             ║
║                     ║                             ║
║                     ║                             ║
║                                                   ║
║                                  ║                ║
║                                  ║                ║
║                                  ║                ║
║                                  ║                ║
║                                ══╩══              ║
║                                                   ║
║                                                   ║
║                                                   ║
║                                                   ║
╚═══════════════════════════════════════════════════╝